POTION	POTION
SUPER_POTION	SUPER_POTION
HYPER_POTION	HYPER_POTION
POTION_MAX	MAX_POTION
GUERISON	FULL_RESTORE
ANTIDOTE	ANTIDOTE
ANTI_PARA	PARALYZE_HEAL
ANTI_BRULE	BURN_HEAL
ANTIGEL	ICE_HEAL
REVEIL	AWAKENING
TOTAL_SOIN	FULL_HEAL
JUS_DE_BAIE	BERRY_JUICE
EAU_FRAICHE	FRESH_WATER
SODA_COOL	SODA_POP
LIMONADE	LEMONADE
LAIT_MEUMEU	MOOMOO_MILK
RAPPEL	REVIVE
RAPPEL_MAX	MAX_REVIVE
ELIXIR	ELIXIR
MAX_ELIXIR	MAX_ELIXIR
HUILE	ETHER
HUILE_MAX	MAX_ETHER
CENDRESACREE	SACRED_ASH